1111111111111111112111111111111111111111
1000000000000000000000000000000000000001
1011111111101111111111111101111111111101
1000000000000000001000000000000000000001
1011111111111111101011111111111111111101
1010000000000000001000000000000000000101
1010111111101111111111111101111111110101
1010100000000000000000000000000000010101
1010111111111111110111111111111111110101
1010000000000000000000000000000000000101
1010101010101111111111111111010101010101
1000101010100000000000000000010101010001
1111101010111111110111111111110101011111
1000001010000000000000000000000101000001
1011111011111110111111011111111101111101
1000000000000000000000000000000000000001
1011111111110111111111111011111111111101
1010000000000111111111111000000000000101
1010111111010111111111111010111111110101
1010000000010111011110111010000000000101
1010111111010111111111111010111111110101
1010000000010111111111111010000000000101
1010111111010111111111111010111111110101
1010000000010101111111101010000000000101
1010111111010110111111011010111111110101
1010000000010111000000111010000000000101
1011111011110111111111111011111101111101
1000000000000000000000000000000000000001
1011111111111110111111011111111111111101
1010000000000000000000000000000000000101
1010111111111111111111111111111111110101
1010000000000000000000000000000000000101
1010101110101011101111011101010111010101
1010100000101000000000000001010000010101
1010101010101010101111010101010101010101
1010101010101010100000010101010101010101
1010101010101010101111010101010101010101
1010101010101010101111010101010101010101
1000000000000000000000000000000000000001
1111111111111111111111111111111111111111
