1111111111111111112111111111111111111111
1000000001000000000000000000010000000001
1011110101011111111111111111010101111101
1010000100000000000000000000000100000101
1010111111111011111111111011111111110101
1010100000000000000100000000000000010101
1010101111111111110101111111111111010101
1010100000000000000100000000000000010101
1010101111111111110101111111111111010101
1010100000000000000100000000000000010101
1010101111111111110101111111111111010101
1000100000000000000000000000000000010001
1110101111111111110101111111111111010111
1000100000000000000100000000000000010001
1011101111111111110101111111111111011101
1010000000000000000100000000000000000101
1010101111111111110101111111111111010101
1010100000000000000100000000000000010101
1010101111111111110101111111111111010101
1010100000000000000000000000000000010101
1010101111111111110101111111111111010101
1010100000000000000100000000000000010101
1010101111111111110101111111111111010101
1010100000000000000100000000000000010101
1010101111111111110101111111111111010101
1010100000000000000100000000000000010101
1010101111111111110101111111111111010101
1000100000000000000100000000000000010001
1110101111111111110101111111111111010111
1000100000000000000100000000000000010001
1010101111111111110101111111111111010101
1010100000000000000100000000000000010101
1010101111111111110101111111111111010101
1010100000000000000100000000000000010101
1010101111111111110101111111111111010101
1010100000000000000100000000000000010101
1010001101011111111111111111010111000101
1011111101011111111111111111010111111101
1000000001000000000000000000010000000001
1111111111111111111111111111111111111111
